....................................................
............XXXXXXXXX.X..........................XXX
............XXX....XXXX..........................XXX
XXXX........XXX......XXXXXX................XXXXXXXXX
XXX................XXXXXX..............XXXXXXXXXXX..
X...........................XX......................
........XXXX..............XXX.......................
XXXXXXXXXXXXXXX.................................XXXX
XXXXXXX.........................XXX............XXXXX
